Amharic	am
Arabic	ar
Armenian	hy
Assamese	as
Bashkir	ba
Bengali (Bangla)	bn
Bishnupriya Manipuri	bpy
Divehi (Maldivian)	dv
Egyptian Arabic	arz
Georgian	ka
Gujarati	gu
Hindi	hi
Javanese	jv
Kannada	kn
Kapampangan	pam
Khmer	km
Korean	ko
Kurdish Sorani	ckb
Maithili	mai
Malayalam	ml
Marathi	mr
Minangkabau	min
Mingrelian	xmf
Mongolian	mn
Nepali	ne
Persian	fa
Punjabi	pnb
Sindhi	sd
Sinhala	si
Somali	so
Sundanese	su
Tamil	ta
Tatar	tt
Telugu	te
Thai	th
Tibetan	bo
Urdu	ur
Uyghur	ug
Uzbek	uz
